NO ./textures/pillar.png
SO ./textures/wall_1.png
WE ./textures/bluestone.png
EA ./textures/eagle.png

C 7, 1, 3
F 10, 30, 20

111111111
1N0000011
101111001
101  1001
1011111D1
111111111