NO ./textures/pillar.png
SO ./textures/wall_1.png
WE ./textures/bluestone.png
EA ./textures/eagle.png

C 7, 1, 3
F 10, 30, 20

        1111111111111111111111111
        1000000000110000000000001
        1011000001110000000000001
        1001000001D00000000000111111
111111111011000001110000000000001
100000000011000001110111111111111
11110111111111011100000000001
11110111111111011101010010001
11000001110101011100000010001
10000001 10000000011000000D01
10000001110000001101010010001
1100000111011011111011110N0111
11110111 1110101 101111010001
11111111 1111111 111111111111
