NO ./textures/pillar.png
SO ./textures/wall_1.png
WE ./textures/bluestone.png
EA ./textures/eagle.png

C 7, 1, 3
F 10, 30, 20

1111111111111111111111111111
1000000000000000000000000001
11111111D1111111111111111111
1000000000000000000000000001
111111111111111D111111111111
1000000000000000000000000001
111111111111111111111111D111
1000000000000000000000000001
11111111111111D1111111111111
10000000000000000000000000N1
1111111111111111111111111111